128
48
0 1 1 1 1 1 1 1 1 1 2 3 3 3 3 3 3 3 3 3 3 3 3 3 3 3 3 3 3 3 3 3 3 3 3 3 3 3 3 3 3 3 3 3 3 3 3 3 3 3 3 3 3 3 3 3 3 3 3 3 3 3 3 4 0 1 1 1 1 1 1 1 1 1 1 1 1 1 1 0 5 6 7 6 7 6 7 6 7 6 7 6 7 6 7 6 7 6 7 6 7 6 7 6 7 6 7 6 7 6 7 6 8 9 10 6 7 6 8 9 10 6 7 6 7 6 7 4
5 11 12 13 14 11 12 13 14 3 3 3 3 3 3 3 3 3 3 3 3 3 3 3 3 3 3 3 3 3 3 3 3 3 3 3 3 3 3 3 3 3 3 3 3 3 3 3 3 3 3 3 3 3 3 3 3 3 3 3 3 3 3 4 5 15 16 15 16 15 16 15 16 15 16 15 16 15 16 4 5 15 16 15 16 15 16 15 16 15 16 15 16 15 16 15 16 15 16 15 16 15 16 15 16 15 16 15 16 15 16 15 8 9 10 15 16 15 8 9 10 15 16 15 16 15 16 4
5 17 18 19 20 17 18 19 20 3 3 3 3 3 3 3 3 3 3 3 3 3 3 3 3 3 3 3 3 3 3 3 3 3 3 3 3 3 3 3 3 3 3 3 3 3 3 3 3 3 3 3 3 3 3 3 3 3 3 3 3 3 3 4 5 6 7 6 7 6 7 6 7 6 7 6 7 6 7 4 5 6 7 6 7 6 7 6 7 6 7 6 7 6 7 6 7 6 7 6 7 6 7 6 7 6 7 6 7 6 7 6 8 9 10 6 7 6 8 9 10 6 7 6 7 6 7 4
5 21 22 23 24 21 22 23 24 3 3 3 3 3 3 3 3 3 3 3 3 3 3 3 3 3 3 3 3 3 3 3 3 3 3 3 3 3 3 3 3 3 3 3 3 3 3 3 3 3 3 3 3 3 3 3 3 3 3 3 3 3 3 4 5 15 16 15 16 15 16 15 16 15 16 15 16 15 16 4 5 15 16 15 16 15 16 15 16 15 16 15 16 15 16 15 16 15 16 15 16 15 16 15 16 15 16 15 16 15 16 15 8 9 10 15 16 15 8 9 10 15 16 15 16 15 16 4
5 19 20 17 18 19 20 17 18 3 3 3 3 3 3 3 3 3 3 3 3 3 3 3 3 3 3 3 3 3 3 3 3 3 3 3 3 3 3 3 3 3 3 3 3 3 3 3 3 3 3 3 3 3 3 3 3 3 3 3 3 3 3 4 5 6 7 6 7 6 7 6 7 6 7 6 7 6 7 4 5 6 7 6 7 6 7 6 7 6 7 6 7 6 7 6 7 6 7 6 7 6 7 6 7 6 7 6 7 6 7 6 8 25 10 6 7 6 8 25 10 6 7 6 7 26 27 4
5 23 24 21 22 23 24 21 22 3 3 3 3 3 3 3 3 3 3 28 29 30 3 28 29 30 3 3 3 31 32 33 3 3 3 3 3 3 3 3 3 3 3 3 3 3 3 3 3 3 3 3 3 3 3 3 3 3 3 3 3 3 3 4 5 15 16 15 16 15 16 15 16 15 16 15 16 15 16 4 5 15 16 15 16 15 16 15 16 15 16 15 16 15 16 15 16 15 16 15 16 15 16 15 16 15 8 9 10 15 16 15 34 35 36 37 38 38 34 35 36 15 16 15 16 39 40 4
5 17 18 19 20 17 18 19 20 3 3 3 3 3 3 3 3 3 3 3 3 3 3 3 3 3 3 3 3 3 3 3 3 3 3 41 3 3 3 3 3 3 3 3 3 3 3 3 3 3 3 3 3 3 3 3 3 3 3 3 3 3 3 4 5 6 7 6 7 6 7 6 7 6 7 6 7 6 7 4 5 6 7 6 7 6 7 6 7 6 7 6 7 6 7 6 7 6 7 6 7 6 7 6 7 6 42 43 44 6 7 6 8 9 10 45 46 46 8 9 10 6 7 6 7 47 48 4
5 21 22 49 50 50 51 23 24 3 3 3 52 53 54 3 3 3 3 3 3 3 3 3 3 3 3 3 3 3 3 3 3 3 3 3 3 3 3 3 3 3 3 3 3 3 3 3 3 3 3 3 3 3 3 3 3 3 3 3 3 3 3 4 5 15 16 15 16 15 16 15 16 15 16 15 16 15 16 55 2 15 16 15 16 15 16 15 16 15 16 15 16 15 16 15 16 15 16 15 16 15 16 15 16 15 8 9 10 37 38 38 8 9 10 45 46 46 8 9 10 37 38 38 38 56 57 4
5 19 20 4 0 0 5 17 18 3 3 3 58 59 60 3 3 3 3 3 3 3 3 3 3 3 3 3 3 3 3 3 3 3 3 3 3 3 3 3 3 3 3 3 3 3 3 3 3 3 3 3 3 3 3 3 3 3 3 3 3 3 3 4 5 6 7 61 62 62 63 6 7 6 7 6 7 6 7 6 7 6 7 6 7 6 7 6 7 6 7 6 64 6 7 65 7 6 64 6 7 65 7 6 7 6 8 9 10 45 46 46 8 9 10 45 46 46 8 9 10 45 46 66 67 67 67 0
68 50 50 69 0 0 68 50 50 50 51 3 3 3 3 3 3 3 3 3 3 3 3 3 3 3 3 3 3 3 3 3 3 3 3 3 3 3 41 3 3 3 3 66 70 3 3 3 41 3 3 3 41 3 3 3 41 3 3 3 3 3 3 4 5 15 16 71 72 72 73 15 16 15 16 15 16 15 16 15 16 15 16 15 74 75 16 15 74 75 16 15 76 15 16 76 16 15 76 15 16 76 16 15 16 15 8 9 10 45 46 46 8 9 10 45 46 46 8 9 10 45 46 43 43 77 78 4
0 1 1 1 1 1 1 1 1 1 2 3 3 3 3 3 3 3 3 3 3 3 3 3 3 3 3 3 3 3 3 3 3 3 3 3 3 3 3 3 3 3 3 3 3 3 3 3 3 3 3 3 3 3 3 3 3 3 3 3 3 3 3 4 5 6 7 4 0 0 5 6 7 61 62 62 62 62 62 62 62 63 7 6 47 48 7 6 26 27 7 6 79 6 7 80 7 6 79 6 7 80 7 6 61 62 62 62 62 62 62 62 62 62 62 62 62 62 62 62 62 62 62 62 62 63 81 4
5 3 3 3 3 3 3 3 3 3 3 3 3 3 3 3 3 3 3 3 3 3 3 3 3 3 3 3 3 3 3 3 3 3 3 3 3 3 3 3 3 3 3 3 3 3 3 3 3 3 3 3 3 3 3 3 3 3 3 66 70 3 3 4 5 82 83 4 0 0 5 82 83 71 72 72 72 72 72 72 72 73 83 82 56 57 83 82 39 40 83 82 83 82 83 82 83 82 83 82 83 82 83 82 71 72 72 72 72 72 72 72 72 72 72 72 72 72 72 72 72 72 72 72 72 73 81 4
5 3 3 3 3 3 3 3 3 3 3 3 3 3 3 3 3 3 3 3 3 3 3 3 3 3 3 3 3 3 3 3 3 3 3 3 3 3 3 3 3 3 3 3 3 3 3 3 3 3 3 3 3 3 3 3 3 3 3 3 3 3 3 4 43 43 43 43 43 43 43 43 43 43 43 43 43 43 43 43 43 43 43 43 43 43 43 43 43 43 43 43 43 43 43 43 43 43 43 43 43 43 43 43 43 43 43 43 43 43 43 43 84 43 43 43 43 43 43 43 85 43 43 43 86 84 87 86
5 3 3 3 3 3 3 3 3 3 3 3 3 3 3 3 3 3 3 3 3 3 3 3 3 3 3 3 3 3 3 3 3 3 3 3 3 3 3 3 3 3 3 3 3 3 3 3 3 3 3 3 3 3 3 3 3 3 3 3 3 3 3 4 43 43 43 43 43 43 43 43 43 43 43 43 43 43 43 43 43 43 43 43 43 43 43 43 43 43 43 43 43 43 43 43 43 43 43 43 43 43 43 43 43 43 43 43 43 43 43 43 84 43 43 43 43 43 43 43 88 43 43 43 86 84 87 86
5 3 3 3 3 3 3 3 3 3 3 3 3 3 23 24 21 22 23 24 3 3 23 24 21 22 23 24 3 3 3 3 3 3 3 3 3 3 3 3 3 3 3 3 3 3 3 3 3 3 3 3 3 3 3 3 3 3 3 3 3 3 3 4 43 43 43 43 43 43 43 43 43 43 43 43 43 43 43 43 43 43 43 43 43 43 43 43 43 43 43 43 43 43 43 43 43 43 43 43 43 43 43 43 43 43 43 43 43 43 43 43 84 43 89 90 43 43 91 92 92 93 43 43 94 95 87 86
5 3 3 3 3 3 3 3 3 3 3 3 3 3 17 18 19 20 17 18 3 3 17 18 19 20 17 18 3 3 3 3 3 3 3 3 3 3 3 3 3 3 3 3 3 3 3 3 3 3 3 3 3 3 3 3 3 3 3 3 3 3 66 0 43 43 43 43 43 43 43 43 43 43 43 43 43 43 43 43 43 43 43 43 43 43 43 43 43 43 43 43 43 43 43 43 43 43 43 43 43 43 43 43 43 43 43 43 43 43 43 43 84 96 97 98 43 91 99 100 100 101 93 43 43 43 43 86
5 3 3 3 3 3 3 3 3 3 3 3 3 3 21 22 23 24 21 22 3 3 21 22 23 24 21 22 3 3 3 3 3 3 3 3 3 3 3 3 3 3 3 3 3 102 103 104 3 3 3 3 3 3 3 3 3 22 23 24 21 22 11 4 43 43 43 43 43 43 43 43 43 43 43 43 43 43 43 43 43 43 43 43 43 43 43 43 43 43 43 43 43 43 43 43 43 43 43 43 43 43 43 43 43 43 43 43 43 43 43 43 84 90 96 43 43 105 106 106 106 107 101 92 92 92 92 108
5 3 3 3 3 3 3 3 3 3 3 3 3 3 19 20 41 109 109 41 3 3 41 110 110 41 19 20 3 3 3 3 3 3 3 3 3 102 111 112 113 114 115 116 117 118 116 118 116 118 116 118 119 118 120 121 118 20 17 18 19 20 17 4 43 43 43 43 43 43 43 43 43 43 43 43 43 43 43 43 43 43 43 43 43 43 43 43 43 43 43 43 43 43 43 43 43 43 43 43 43 43 43 43 43 43 43 43 43 43 43 43 84 98 43 43 43 85 122 122 122 94 106 106 106 106 106 107
5 3 3 3 103 104 3 3 3 3 3 3 3 3 23 24 13 14 11 12 114 3 11 12 13 14 123 24 102 115 124 125 118 116 119 117 118 116 118 116 126 127 128 128 128 128 128 128 128 128 129 130 131 132 133 49 51 24 21 22 23 24 21 4 43 43 43 43 43 43 43 43 43 43 43 43 43 43 43 43 43 43 43 43 43 43 43 43 43 43 43 43 43 43 43 43 43 43 43 43 43 43 43 43 43 43 43 43 43 43 43 43 134 92 92 135 43 88 136 136 136 122 137 43 43 43 43 86
5 116 118 116 118 116 118 119 118 116 120 121 117 116 17 18 19 20 17 18 118 117 17 18 19 20 41 18 127 128 128 128 129 130 131 132 128 128 129 130 131 132 133 138 128 128 128 129 139 140 131 131 131 131 140 4 5 18 19 49 50 50 50 69 43 43 43 43 43 43 43 43 43 43 43 43 43 43 43 43 43 43 43 43 43 43 43 43 43 43 43 43 43 43 43 43 43 43 43 43 43 43 43 43 43 43 43 43 43 43 43 43 100 100 100 84 43 141 136 136 136 136 142 43 43 43 43 86
5 128 128 133 138 129 130 131 132 128 128 128 128 128 21 22 23 24 49 50 50 50 50 51 23 24 13 22 128 128 129 140 131 131 131 131 140 139 131 131 131 131 140 140 143 140 139 131 131 131 131 131 144 145 50 69 5 22 23 55 1 1 1 0 43 43 43 43 43 43 43 43 43 43 43 43 43 43 43 43 43 43 43 43 43 43 43 43 43 43 43 43 43 43 43 43 43 43 43 43 43 43 43 43 43 43 43 43 43 43 43 43 146 106 106 95 43 85 136 136 136 136 142 43 43 43 43 86
5 140 143 140 139 131 131 131 131 140 139 140 140 49 51 20 17 18 4 0 0 0 0 5 17 18 19 20 139 143 144 145 50 50 147 148 131 131 144 145 50 50 147 148 131 131 131 131 131 131 144 149 150 0 0 0 5 20 17 43 43 77 78 4 43 43 43 43 43 43 43 43 43 43 43 43 43 43 43 43 43 43 43 43 43 43 43 43 43 43 43 43 43 43 43 43 43 43 43 43 43 43 43 43 43 43 43 43 43 43 43 43 84 151 152 43 43 88 136 141 136 136 141 43 43 153 154 86
68 50 50 50 50 50 50 50 50 50 50 50 50 69 68 50 50 50 69 0 0 0 0 68 51 110 110 110 110 49 155 0 0 0 0 156 50 50 155 0 0 0 0 156 51 110 110 110 110 49 155 0 0 0 0 0 68 50 50 50 50 51 81 4 43 43 43 43 43 43 43 43 43 43 43 43 43 43 43 43 43 43 43 43 43 43 43 43 43 43 43 43 43 43 43 43 43 43 43 43 43 43 43 43 43 43 43 43 43 43 43 43 84 87 157 92 135 88 136 122 136 136 137 43 43 158 159 86
0 0 0 0 0 0 0 0 0 0 0 0 0 0 0 0 0 0 0 0 0 0 0 0 0 72 72 72 72 0 0 0 0 0 0 0 0 0 0 0 0 0 0 0 0 72 72 72 72 0 0 0 0 0 0 0 0 0 0 0 0 5 81 4 43 43 43 43 43 43 43 43 43 43 43 43 43 43 43 43 43 43 43 43 43 43 43 43 43 43 43 43 43 43 43 43 43 43 43 43 43 43 43 43 43 43 43 43 43 43 43 43 84 87 86 100 84 88 136 136 136 136 142 43 43 86 100 100
43 43 43 43 43 43 43 43 43 43 43 43 43 43 43 43 43 43 43 43 43 43 43 43 43 43 43 43 43 43 43 43 100 100 100 100 100 100 100 100 100 100 100 100 100 100 100 100 100 100 100 100 100 100 100 100 100 100 100 100 100 84 87 86 43 43 43 43 43 43 43 43 43 43 43 43 43 43 43 43 43 43 43 43 43 43 43 43 43 43 43 43 43 43 43 43 43 43 43 43 43 43 43 43 43 43 43 43 43 43 43 43 84 87 86 100 84 88 136 136 136 136 142 43 43 86 100 100
43 43 43 43 43 43 43 43 43 43 43 43 43 43 43 43 43 43 43 43 43 43 43 43 43 43 43 43 43 43 43 43 100 146 106 106 106 106 106 107 100 146 106 106 106 106 106 106 107 146 106 106 106 106 106 106 106 106 106 106 107 84 87 86 43 43 43 43 43 43 43 43 43 43 43 43 43 43 43 43 43 43 43 43 43 43 43 43 43 43 43 43 43 43 43 43 43 43 43 43 43 43 43 43 43 43 43 43 43 43 43 43 84 87 94 106 95 88 136 136 136 136 142 43 43 94 107 100
43 43 43 43 43 43 43 43 43 43 43 43 43 43 43 43 43 43 43 43 43 43 43 43 43 43 43 43 43 43 43 43 100 84 122 122 137 43 43 86 100 84 122 122 122 122 122 85 86 84 122 122 122 122 122 122 85 122 137 43 94 95 43 86 43 43 43 43 43 43 43 43 43 43 43 43 43 43 43 43 43 43 43 43 43 43 43 43 43 43 43 43 43 43 43 43 43 43 43 43 43 43 43 43 43 43 43 43 43 43 43 43 84 43 43 43 160 88 161 162 162 162 163 43 43 43 86 100
43 43 43 43 43 43 43 43 43 43 43 43 43 43 43 43 43 43 43 43 43 43 43 43 43 43 43 43 43 43 43 43 100 84 136 136 164 89 90 94 106 95 136 136 136 136 136 88 86 84 162 165 136 161 162 162 88 162 163 43 43 43 43 86 43 43 43 43 43 43 43 43 43 43 43 43 43 43 43 43 43 43 43 43 43 43 43 43 43 43 43 43 43 43 43 43 43 43 43 43 43 43 43 43 43 43 43 43 43 43 43 43 84 43 89 90 166 88 163 43 43 43 43 43 43 43 86 100
43 43 43 43 43 43 43 43 43 43 43 43 43 43 43 43 43 43 43 43 43 43 43 43 43 43 43 43 43 43 43 43 100 84 136 141 142 97 98 43 160 122 161 162 162 165 136 88 94 95 43 167 136 142 43 43 88 43 43 43 43 43 43 86 43 43 43 43 43 43 43 43 43 43 43 43 43 43 43 43 43 43 43 43 43 43 43 43 43 43 43 43 43 43 43 43 43 43 43 43 43 43 43 43 43 43 43 43 43 43 43 43 134 92 168 98 169 88 43 43 43 43 43 43 43 89 86 100
43 43 43 43 43 43 43 43 43 43 43 43 43 43 43 43 43 43 43 43 43 43 43 43 43 43 43 43 43 43 43 43 100 84 136 122 142 43 170 171 167 136 142 43 43 167 136 88 137 43 43 166 162 163 43 171 88 43 43 91 92 92 92 108 43 43 43 43 43 43 43 43 43 43 43 43 43 43 43 43 43 43 43 43 43 43 43 43 43 43 43 43 43 43 43 43 43 43 43 43 43 43 43 43 43 43 43 43 43 43 43 43 146 106 95 169 43 88 43 43 43 43 43 43 91 92 108 100
43 43 43 43 43 43 43 43 43 43 43 43 43 43 43 43 43 43 43 43 43 43 43 43 43 43 43 43 43 43 43 43 100 84 162 162 163 43 43 43 166 162 163 43 43 167 136 88 142 43 171 172 43 43 173 174 88 43 91 99 100 100 100 100 43 43 43 43 43 43 43 43 43 43 43 43 43 43 43 43 43 43 43 43 43 43 43 43 43 43 43 43 43 43 43 43 43 43 43 43 43 43 43 43 43 43 43 43 43 43 43 43 84 43 43 43 169 88 90 43 43 43 43 91 99 100 100 100
43 43 43 43 43 43 43 43 43 43 43 43 43 43 43 43 43 43 43 43 43 43 43 43 43 43 43 43 43 43 43 43 100 84 43 157 92 175 176 43 43 43 43 43 43 166 162 88 163 43 170 89 90 173 174 43 88 91 99 100 100 100 100 100 43 43 43 43 43 43 43 43 43 43 43 43 43 43 43 43 43 43 43 43 43 43 43 43 43 43 43 43 43 43 43 43 43 43 43 43 43 43 43 43 43 43 43 43 43 43 43 43 84 43 43 43 177 178 98 43 43 43 91 99 100 100 100 100
43 43 43 43 43 43 43 43 43 43 43 43 43 43 43 43 43 43 43 43 43 43 43 43 43 43 43 43 43 43 43 43 100 84 43 86 100 100 179 180 176 43 43 43 43 43 43 88 43 91 92 168 98 174 157 92 92 181 100 100 100 100 100 100 43 43 43 43 43 43 43 43 43 43 43 43 43 43 43 43 43 43 43 43 43 43 43 43 43 43 43 43 43 43 43 43 43 43 43 43 43 43 43 43 43 43 43 43 43 43 43 43 84 43 43 43 173 85 43 43 43 43 105 106 106 106 106 107
43 43 43 43 43 43 43 43 43 43 43 43 43 43 43 43 43 43 43 43 43 43 43 43 43 43 43 43 43 43 43 43 100 84 87 86 100 100 100 100 179 180 176 43 43 43 43 88 91 99 100 84 43 43 86 100 100 100 100 100 100 100 100 100 43 43 43 43 43 43 43 43 43 43 43 43 43 43 43 43 43 43 43 43 43 43 43 43 43 43 43 43 43 43 43 43 43 43 43 43 43 43 43 43 43 43 43 43 43 43 43 43 84 43 43 171 174 88 43 43 43 43 43 43 43 152 182 86
43 43 43 43 43 43 43 43 43 43 43 43 43 43 43 43 43 43 43 43 43 43 43 43 43 43 43 43 43 43 43 43 100 84 87 86 100 100 100 100 100 100 179 92 135 154 157 92 181 100 100 84 154 154 86 100 100 100 100 100 100 100 100 100 43 43 43 43 43 43 43 43 43 43 43 43 43 43 43 43 43 43 43 43 43 43 43 43 43 43 43 43 43 43 43 43 43 43 43 43 43 43 43 43 43 43 43 43 43 43 43 43 84 154 154 154 177 183 183 184 154 157 92 92 92 135 87 86
43 43 43 43 43 43 43 43 43 43 43 43 43 43 43 43 43 43 43 43 43 43 43 43 43 43 43 43 43 43 43 43 100 84 87 86 100 100 100 100 100 100 100 100 84 159 86 100 100 100 100 84 159 159 86 100 100 100 100 100 100 100 100 100 43 43 43 43 43 43 43 43 43 43 43 43 43 43 43 43 43 43 43 43 43 43 43 43 43 43 43 43 43 43 43 43 43 43 43 43 43 43 43 43 43 43 43 43 43 43 43 43 84 159 159 159 185 185 185 185 159 86 100 100 100 84 87 86
43 43 43 43 43 43 43 43 43 43 43 43 43 43 43 43 43 43 43 43 43 43 43 43 43 43 43 43 43 43 43 43 100 84 87 86 100 100 100 100 100 100 100 100 100 100 100 100 100 100 100 100 100 100 100 100 100 100 100 100 100 100 100 100 100 100 100 100 100 100 100 100 100 100 100 100 100 100 100 100 84 186 186 186 186 186 186 186 186 186 186 186 186 186 186 186 186 186 186 186 186 186 186 186 186 186 186 186 186 186 186 86 100 100 146 106 106 106 106 106 106 106 106 106 107 84 87 86
43 43 43 43 43 43 43 43 43 43 43 43 43 43 43 43 43 43 43 43 43 43 43 43 43 43 43 43 43 43 43 43 100 84 87 86 146 106 106 106 107 146 106 106 106 106 106 106 106 106 106 106 106 106 106 106 106 106 106 106 106 106 106 106 106 106 107 100 146 106 106 106 106 106 106 106 107 100 100 100 84 186 186 186 186 186 186 186 186 186 186 186 186 186 186 186 186 186 186 186 186 186 186 186 186 186 186 186 186 186 186 86 100 100 84 122 122 122 122 122 122 122 122 122 86 84 87 86
43 43 43 43 43 43 43 43 43 43 43 43 43 43 43 43 43 43 43 43 43 43 43 43 43 43 43 43 43 43 43 43 100 84 87 86 84 122 122 122 86 84 122 122 122 122 122 85 122 122 122 85 122 122 122 122 122 122 122 122 122 85 122 122 122 122 86 100 84 43 160 122 122 85 122 122 86 100 100 100 84 186 186 186 186 186 186 186 186 186 186 186 186 186 186 186 186 186 186 186 186 186 186 186 186 186 186 186 186 186 186 86 100 100 84 136 136 136 136 136 136 136 136 136 86 84 87 86
43 43 43 43 43 43 43 43 43 43 43 43 43 43 43 43 43 43 43 43 43 43 43 43 43 43 43 43 43 43 43 43 100 84 43 86 84 162 162 162 86 84 162 165 136 161 162 88 162 162 165 88 136 136 136 136 136 136 161 162 165 88 136 136 136 136 94 106 95 43 167 136 136 88 136 136 86 100 100 100 84 186 186 186 186 186 186 186 186 186 186 186 186 186 186 186 186 186 186 186 186 186 186 186 186 186 186 186 186 186 186 86 100 100 84 162 162 162 162 162 162 162 162 162 86 84 87 86
43 43 43 43 43 43 43 43 43 43 43 43 43 43 43 43 43 43 43 43 43 43 43 43 43 43 43 43 43 43 43 43 146 95 43 94 95 89 90 43 94 95 43 167 136 142 177 183 184 43 166 88 162 162 162 165 136 136 142 43 166 88 162 162 162 165 122 85 137 43 166 162 162 88 162 162 86 100 100 146 95 186 186 186 186 186 186 186 186 186 186 186 186 186 186 186 186 186 186 186 186 186 186 186 186 186 186 186 186 186 186 94 107 100 84 187 188 188 188 188 188 188 188 189 86 84 87 86
43 43 43 43 43 43 43 43 43 43 43 43 43 43 43 43 43 43 43 43 43 43 43 43 43 43 43 43 43 43 43 43 84 122 136 137 43 97 98 169 43 43 43 166 162 163 43 85 43 43 43 88 43 43 43 167 136 136 142 43 43 88 43 43 43 166 162 88 163 43 43 43 43 88 43 43 94 106 106 95 190 191 192 192 192 192 191 192 192 192 192 191 192 192 192 192 191 192 192 192 192 191 192 192 192 192 191 192 192 192 192 190 94 106 95 43 43 43 43 43 43 171 172 43 86 84 87 86
43 43 43 43 43 43 43 43 43 43 43 43 43 43 43 43 43 43 43 43 43 43 43 43 43 43 43 43 43 43 43 43 84 162 162 163 43 43 169 43 169 43 193 194 43 43 89 88 43 91 92 92 175 176 43 166 162 162 163 43 177 183 184 43 43 43 43 88 43 43 89 90 177 183 184 171 43 43 43 195 196 197 198 199 200 198 197 198 199 200 198 197 198 199 200 198 197 198 199 200 198 197 198 199 200 198 197 198 199 200 198 196 201 43 43 43 43 43 43 43 43 170 89 90 86 84 87 86
43 43 43 43 43 43 43 43 43 43 43 43 43 43 43 43 43 43 43 43 43 43 43 43 43 43 43 43 43 43 43 43 134 92 93 43 43 43 43 169 89 90 96 43 43 43 97 88 91 99 100 100 100 179 180 176 43 43 43 43 43 85 43 43 202 43 43 88 43 43 97 98 43 85 173 174 43 43 43 203 204 205 206 207 208 206 205 206 207 208 206 205 206 207 208 206 205 206 207 208 206 205 206 207 208 206 205 206 207 208 206 204 209 43 43 43 43 43 43 43 43 43 97 98 86 84 87 86
43 43 43 43 43 43 43 43 43 43 43 43 43 43 43 43 43 43 43 43 43 43 43 43 43 43 43 43 43 43 43 43 100 100 210 93 43 43 43 43 211 98 43 43 43 91 92 92 181 100 100 100 100 100 100 179 180 176 43 43 43 88 90 173 174 43 91 92 93 43 170 172 43 88 174 43 212 213 92 135 214 215 216 216 216 216 215 216 216 216 216 215 216 216 216 216 215 216 216 216 216 215 216 216 216 216 215 216 216 216 216 214 157 92 135 43 43 43 43 43 43 43 43 43 94 95 87 86
43 43 43 43 43 43 43 43 43 43 43 43 43 43 43 43 43 43 43 43 43 43 43 43 43 43 43 43 43 43 43 43 100 100 100 210 93 43 43 43 158 43 43 43 91 99 100 100 100 100 100 100 100 100 100 100 100 179 180 176 43 88 98 174 43 91 99 100 210 93 43 170 89 88 212 213 217 100 100 134 135 185 185 185 185 185 185 185 185 185 185 185 185 185 185 185 185 185 185 185 185 185 185 185 185 185 185 185 185 185 185 157 108 100 84 90 43 43 43 43 43 43 43 43 43 152 218 86
43 43 43 43 43 43 43 43 43 43 43 43 43 43 43 43 43 43 43 43 43 43 43 43 43 43 43 43 43 43 43 43 100 100 100 100 210 135 154 154 158 154 154 157 181 100 100 100 100 100 100 100 100 100 100 100 100 100 100 179 92 92 92 135 154 105 106 106 106 219 154 157 92 92 220 100 100 100 100 100 84 186 186 186 186 186 186 186 186 186 186 186 186 186 186 186 186 186 186 186 186 186 186 186 186 186 186 186 186 186 186 86 100 100 134 168 154 154 154 154 154 154 154 157 92 92 92 108
43 43 43 43 43 43 43 43 43 43 43 43 43 43 43 43 43 43 43 43 43 43 43 43 43 43 43 43 43 43 43 43 100 100 100 100 100 84 159 159 158 159 159 86 100 100 100 100 100 100 100 100 100 100 100 100 100 100 100 100 100 100 100 84 159 185 185 185 185 185 159 86 100 100 100 100 100 100 100 100 84 186 186 186 186 186 186 186 186 186 186 186 186 186 186 186 186 186 186 186 186 186 186 186 186 186 186 186 186 186 186 86 100 100 100 84 159 159 159 159 159 159 159 86 100 100 100 100