0 1 2 3 5 6 94
1 100
2 101 102
3 23 103 18 21
4 19 21
5 23 25 28
6 34 80 28 
7 80 81 132
8 83 80
9 86
10 87 88 89
11 140 139
12 138 139
13 91 92 93 135
14 96 196 109 110 111 112 113 114
15 8 96 196 109 110 111 112 113 114
16 10 12 13 95 97 197 109 110 111 112 113 114
17 109 111 112 113 114
18 19
19 27 23 25 28
20 31 33 34 28 55
21 82 81
22 84 507
23 85 86 
24 87 88 89
25 62 90 
26 63 70 134 62 90 220 221
27 74 76 108 90 221 506 604
28 4  1	11
29 7 9 11 4
30 14 98 17 198 199 200 11 945
31 15 16 20 35 109 110 111 125 148 200 204 206 500 502
32 152 22 39 99 112 113 114 149 201 99 205 207 147 502
33 24 26 47 115 116 117 118 150 201 203 202 208 502
34 30 32 51 55 105 34 502 600
35	
36
37
38
39 62
40 64 65 69 71 107 62 63 603
41 72 78 131 147 505 506
42
43
44
45 37 104 133 209 500 35 601 127
46 42 44 209 302 127
47 48 50 44 47 303 304 212 127
48 52 50 211
49
50
51
52
53 62
54 67 68 73 128 145 146 62 312 313
55 77 219 505 602
56
57
58
59 36 38 129 37 45 210 501 503 601 127
60 40 41 43 45 46 127 141 142 38 44 300 301 35 213 503 127
61 49 119 120 121 44 46 48 50 127 214 215 503 127
62 53 54 122 123 124 126 143 50 52 55 143 215 216 217 503
63 56 57 58 59 305 216 217 218 503 126
64 60 61 136 218 901 902 905 906 907 908 909 910
65 60 61 911 912 913 914 915 916 917 918 919 920 921 922
66 60 61 923 924 925 926 927 928 929 930 931 932 933 934
67 137 60 61 903 904 935 936 937 938 939 940 941 942 943 944
68 66 130 61 144 306 307 308 309 310 311 60 504
69 75 79 106 310 311 602 508
70
71
72
73 36 38
74 38 40 43 46 141 300 301
75 46
76 54 143
77 305
78
79
80
81
82 144 306 307 308 309 310 311
83 310 311
