128
48
0 1 1 1 1 1 1 1 1 1 2 3 3 3 3 3 3 3 3 3 3 3 3 3 3 3 3 3 3 3 3 3 3 3 3 3 3 3 3 3 3 3 3 3 3 3 3 3 3 3 3 3 3 3 3 3 3 3 3 3 3 3 3 4 0 1 1 1 1 1 1 1 1 1 1 1 1 1 1 0 5 6 7 6 7 6 7 6 7 6 7 6 7 6 7 6 7 6 7 6 7 6 7 6 7 6 7 6 7 6 7 6 8 9 10 6 7 6 8 9 10 6 7 6 7 6 7 4
5 11 12 13 14 11 12 13 14 3 3 3 3 3 3 3 3 3 3 3 3 3 3 3 3 3 3 3 3 3 3 3 3 3 3 3 3 3 3 3 3 3 3 3 3 3 3 3 3 3 3 3 3 3 3 3 3 3 3 3 3 3 3 4 5 15 16 15 16 15 16 15 16 15 16 15 16 15 16 4 5 15 16 15 16 15 16 15 16 15 16 15 16 15 16 15 16 15 16 15 16 15 16 15 16 15 16 15 16 15 16 15 8 9 10 15 16 15 8 9 10 15 16 15 16 15 16 4
5 17 18 19 20 17 18 19 20 3 3 3 3 3 3 3 3 3 3 3 3 3 3 3 3 3 3 3 3 3 3 3 3 3 3 3 3 3 3 3 3 3 3 3 3 3 3 3 3 3 3 3 3 3 3 3 3 3 3 3 3 3 3 4 5 6 7 6 7 6 7 6 7 6 7 6 7 6 7 4 5 6 7 6 7 6 7 6 7 6 7 6 7 6 7 6 7 6 7 6 7 6 7 6 7 6 7 6 7 6 7 6 8 9 10 6 7 6 8 9 10 6 7 6 7 6 7 4
5 21 22 23 24 21 22 23 24 3 3 3 3 3 3 3 3 3 3 3 3 3 3 3 3 3 3 3 3 3 3 3 3 3 3 3 3 3 3 3 3 3 3 3 3 3 3 3 3 3 3 3 3 3 3 3 3 3 3 3 3 3 3 4 5 15 16 15 16 15 16 15 16 15 16 15 16 15 16 4 5 15 16 15 16 15 16 15 16 15 16 15 16 15 16 15 16 15 16 15 16 15 16 15 16 15 16 15 16 15 16 15 8 9 10 15 16 15 8 9 10 15 16 15 16 25 26 4
5 19 20 17 27 28 20 17 18 3 3 3 3 3 3 3 3 3 3 3 3 3 3 3 3 3 3 3 3 3 3 3 3 3 3 3 3 3 3 3 3 3 3 3 3 3 3 3 3 3 3 3 3 3 3 3 3 3 3 3 3 3 3 4 5 29 30 31 30 31 30 31 30 6 7 6 7 6 7 4 5 6 7 6 7 6 7 6 7 6 7 6 7 6 7 6 7 6 7 6 7 6 7 6 7 6 7 6 7 6 7 6 8 32 10 6 7 6 8 32 10 6 7 6 7 33 34 4
5 23 24 21 35 36 24 21 22 3 3 3 3 3 3 3 3 3 3 37 38 39 3 37 38 39 3 3 3 40 41 42 3 3 3 3 3 3 3 3 3 3 3 3 3 3 3 3 3 3 3 3 3 3 3 3 3 3 3 3 3 3 3 4 5 43 44 45 46 47 48 49 50 15 16 15 16 15 16 4 5 15 16 15 16 15 16 15 16 15 16 15 16 15 16 15 16 15 16 15 16 15 16 15 16 15 8 9 10 15 16 15 51 52 53 54 55 55 51 52 53 15 16 15 16 56 57 4
5 17 18 19 58 59 18 19 20 3 3 3 3 3 3 3 3 3 3 3 3 3 3 3 3 3 3 3 3 3 3 3 3 3 3 60 3 3 3 3 3 3 3 3 3 3 3 3 3 3 3 3 3 3 3 3 3 3 3 3 3 3 3 4 5 61 62 63 64 65 66 67 68 6 7 6 7 6 7 4 5 6 7 6 7 6 7 6 7 6 7 6 7 6 7 6 7 6 7 6 7 6 7 6 7 6 69 70 71 6 7 6 8 9 10 72 73 73 8 9 10 6 7 6 7 74 75 4
5 21 22 76 77 77 78 23 24 3 3 3 79 80 81 3 3 3 3 3 3 3 3 3 3 3 3 3 3 3 3 3 3 3 3 3 3 3 3 3 3 3 3 3 3 3 3 3 3 3 3 3 3 3 3 3 3 3 3 3 3 3 3 4 5 82 83 84 85 86 87 88 89 15 16 15 16 15 16 90 2 15 16 15 16 15 16 15 16 15 16 15 16 15 16 15 16 15 16 15 16 15 16 15 16 15 8 9 10 54 55 55 8 9 10 72 73 73 8 9 10 54 55 55 55 91 92 4
5 19 20 4 0 0 5 17 18 3 3 3 93 94 95 3 3 3 3 3 3 3 3 3 3 3 3 3 3 3 3 3 3 3 3 3 3 3 3 3 3 3 3 3 3 3 3 3 3 3 3 3 3 3 3 3 3 3 3 3 3 3 3 4 5 6 7 96 97 97 98 6 7 6 7 6 7 6 7 6 7 6 7 6 7 6 7 6 7 6 7 6 99 6 7 100 7 6 99 6 7 100 7 6 7 6 8 9 10 72 73 73 8 9 10 72 73 73 8 9 10 72 73 101 102 102 102 0
103 77 77 104 0 0 103 77 77 77 78 3 3 3 3 3 3 3 3 3 3 3 3 3 3 3 3 3 3 3 3 3 3 3 3 3 3 3 60 3 3 3 3 101 105 3 3 3 60 3 3 3 60 3 3 3 60 3 3 3 3 3 3 4 5 15 16 106 107 107 108 15 16 15 16 15 16 15 16 15 16 15 16 15 109 110 16 15 109 110 16 15 111 15 16 111 16 15 111 15 16 111 16 15 16 15 8 9 10 72 73 73 8 9 10 72 73 73 8 9 10 72 73 70 70 112 113 4
0 1 1 1 1 1 1 1 1 1 2 3 3 3 3 3 3 3 3 3 3 3 3 3 3 3 3 3 3 3 3 3 3 3 3 3 3 3 3 3 3 3 3 3 3 3 3 3 3 3 3 3 3 3 3 3 3 3 3 3 3 3 3 4 5 6 7 4 0 0 5 6 7 96 97 97 97 97 97 97 97 98 7 6 74 75 7 6 33 34 7 6 114 6 7 115 7 6 114 6 7 115 7 6 96 97 97 97 97 97 97 97 97 97 97 97 97 97 97 97 97 97 97 97 97 98 116 4
5 3 3 3 3 3 3 3 3 3 3 3 3 3 3 3 3 3 3 3 3 3 3 3 3 3 3 3 3 3 3 3 3 3 3 3 3 3 3 3 3 3 3 3 3 3 3 3 3 3 3 3 3 3 3 3 3 3 3 101 105 3 3 4 5 117 118 4 0 0 5 117 118 106 107 107 107 107 107 107 107 108 118 117 91 92 118 117 56 57 118 117 118 117 118 117 118 117 118 117 118 117 118 117 106 107 107 107 107 107 107 107 107 107 107 107 107 107 107 107 107 107 107 107 107 108 116 4
5 3 3 3 3 3 3 3 3 3 3 3 3 3 3 3 3 3 3 3 3 3 3 3 3 3 3 3 3 3 3 3 3 3 3 3 3 3 3 3 3 3 3 3 3 3 3 3 3 3 3 3 3 3 3 3 3 3 3 3 3 3 3 4 70 70 70 70 70 70 70 70 70 70 70 70 70 70 70 70 70 70 70 70 70 70 70 70 70 70 70 70 70 70 70 70 70 70 70 70 70 70 70 70 70 70 70 70 70 70 70 70 119 120 120 120 120 120 120 120 120 120 120 120 121 122 123 124
5 3 3 3 3 3 3 3 3 3 3 3 3 3 3 3 3 3 3 3 3 3 3 3 3 3 3 3 3 3 3 3 3 3 3 3 3 3 3 3 3 3 3 3 3 3 3 3 3 3 3 3 3 3 3 3 3 3 3 3 3 3 3 4 70 70 70 70 70 70 70 70 70 70 70 70 70 70 70 70 70 70 70 70 70 70 70 70 70 70 70 70 70 70 70 70 70 70 70 70 70 70 70 70 70 70 70 70 70 70 70 70 122 70 70 70 70 70 70 70 125 70 70 70 124 122 123 124
5 3 3 3 3 3 3 3 3 3 3 3 3 3 23 24 21 22 23 24 3 3 23 24 21 22 23 24 3 3 3 3 3 3 3 3 3 3 3 3 3 3 3 3 3 3 3 3 3 3 3 3 3 3 3 3 3 3 3 3 3 3 3 4 70 70 70 70 70 70 70 70 70 70 70 70 70 70 70 70 70 70 70 70 70 70 70 70 70 70 70 70 70 70 70 70 70 70 70 70 70 70 70 70 70 70 70 70 70 70 70 70 122 70 70 70 70 70 70 70 126 70 70 70 124 122 123 124
5 3 3 3 3 3 3 3 3 3 3 3 3 3 17 18 19 20 17 18 3 3 17 18 19 20 17 18 3 3 3 3 3 3 3 3 3 3 3 3 3 3 3 3 3 3 3 3 3 3 3 3 3 3 3 3 3 3 3 3 3 3 101 0 70 70 70 70 70 70 70 70 70 70 70 70 70 70 70 70 70 70 70 70 70 70 70 70 70 70 70 70 70 70 70 70 70 70 70 70 70 70 70 70 70 70 70 70 70 70 70 70 122 70 127 128 70 70 129 130 130 131 70 70 132 133 123 124
5 3 3 3 3 3 3 3 3 3 3 3 3 3 21 22 23 24 21 22 3 3 21 22 23 24 21 22 3 3 3 3 3 3 3 3 3 3 3 3 3 3 3 3 3 134 135 136 3 3 3 3 3 3 3 3 3 22 23 24 21 22 11 4 70 70 70 70 70 70 70 70 70 70 70 70 70 70 70 70 70 70 70 70 70 70 70 70 70 70 70 70 70 70 70 70 70 70 70 70 70 70 70 70 70 70 70 70 70 70 70 70 122 137 138 139 70 129 140 141 141 142 131 70 70 70 70 124
5 3 3 3 3 3 3 3 3 3 3 3 3 3 19 20 60 143 143 60 3 3 60 144 144 60 19 20 3 3 3 3 3 3 3 3 3 134 145 146 147 148 149 150 151 152 150 152 150 152 150 152 153 152 154 155 152 20 17 18 19 20 17 4 70 70 70 70 70 70 70 70 70 70 70 70 70 70 70 70 70 70 70 70 70 70 70 70 70 70 70 70 70 70 70 70 70 70 70 70 70 70 70 70 70 70 70 70 70 70 70 70 122 128 137 70 70 156 120 120 120 121 142 130 130 130 130 157
5 3 3 3 135 136 3 3 3 3 3 3 3 3 23 24 13 14 11 12 148 3 11 12 13 14 158 24 134 149 159 160 152 150 153 151 152 150 152 150 161 162 163 163 163 163 163 163 163 163 164 165 166 167 168 76 78 24 21 22 23 24 21 4 70 70 70 70 70 70 70 70 70 70 70 70 70 70 70 70 70 70 70 70 70 70 70 70 70 70 70 70 70 70 70 70 70 70 70 70 70 70 70 70 70 70 70 70 70 70 70 70 122 139 70 70 70 125 169 169 169 132 120 120 120 120 120 121
170 171 172 173 174 175 176 177 173 178 154 155 151 150 17 18 19 20 17 18 152 151 17 18 19 20 60 18 162 163 163 163 164 165 166 167 163 163 164 165 166 167 168 179 163 163 163 164 180 181 166 166 166 166 181 4 5 18 19 76 77 77 77 104 70 70 70 70 70 70 70 70 70 70 70 70 70 70 70 70 70 70 70 70 70 70 70 70 70 70 70 70 70 70 70 70 70 70 70 70 70 70 70 70 70 70 70 70 70 70 70 70 182 130 130 183 70 126 184 184 184 169 185 70 70 70 70 124
186 187 188 189 190 191 192 193 194 195 163 163 163 163 21 22 23 24 76 77 77 77 77 78 23 24 13 22 163 163 164 181 166 166 166 166 181 180 166 166 166 166 181 181 196 181 180 166 166 166 166 166 197 198 77 104 5 22 23 90 1 1 1 0 70 70 70 70 70 70 70 70 70 70 70 70 70 70 70 70 70 70 70 70 70 70 70 70 70 70 70 70 70 70 70 70 70 70 70 70 70 70 70 70 70 70 70 70 70 70 70 70 141 141 141 122 70 199 184 184 184 184 200 70 70 70 70 124
186 201 202 203 204 205 206 207 208 209 180 181 181 76 78 20 17 18 4 0 0 0 0 5 17 18 19 20 180 196 197 198 77 77 210 211 166 166 197 198 77 77 210 211 166 166 166 166 166 166 197 212 213 0 0 0 5 20 17 70 70 112 113 4 70 70 70 70 70 70 70 70 70 70 70 70 70 70 70 70 70 70 70 70 70 70 70 70 70 70 70 70 70 70 70 70 70 70 70 70 70 70 70 70 70 70 70 70 70 70 70 70 119 120 120 133 70 125 184 184 184 184 200 70 70 214 70 124
215 216 216 216 216 216 216 216 216 216 77 77 77 104 103 77 77 77 104 0 0 0 0 103 78 144 144 144 144 76 217 0 0 0 0 218 77 77 217 0 0 0 0 218 78 144 144 144 144 76 217 0 0 0 0 0 103 77 77 77 77 78 116 4 70 70 70 70 70 70 70 70 70 70 70 70 70 70 70 70 70 70 70 70 70 70 70 70 70 70 70 70 70 70 70 70 70 70 70 70 70 70 70 70 70 70 70 70 70 70 70 70 122 219 220 70 70 126 184 199 184 184 199 70 70 221 222 124
0 0 0 0 0 0 0 0 0 0 0 0 0 0 0 0 0 0 0 0 0 0 0 0 0 107 107 107 107 0 0 0 0 0 0 0 0 0 0 0 0 0 0 0 0 107 107 107 107 0 0 0 0 0 0 0 0 0 0 0 0 5 116 4 70 70 70 70 70 70 70 70 70 70 70 70 70 70 70 70 70 70 70 70 70 70 70 70 70 70 70 70 70 70 70 70 70 70 70 70 70 70 70 70 70 70 70 70 70 70 70 70 122 123 223 130 183 126 184 169 184 184 185 70 70 224 225 124
70 70 70 70 70 70 70 70 70 70 70 70 70 70 70 70 70 70 70 70 70 70 70 70 70 70 70 70 70 70 70 70 141 141 141 141 141 141 141 141 141 141 141 141 141 141 141 141 141 141 141 141 141 141 141 141 141 141 141 141 141 122 123 124 70 70 70 70 70 70 70 70 70 70 70 70 70 70 70 70 70 70 70 70 70 70 70 70 70 70 70 70 70 70 70 70 70 70 70 70 70 70 70 70 70 70 70 70 70 70 70 70 122 123 124 141 122 126 184 184 184 184 200 70 70 124 141 141
70 70 70 70 70 70 70 70 70 70 70 70 70 70 70 70 70 70 70 70 70 70 70 70 70 70 70 70 70 70 70 70 141 119 120 120 120 120 120 121 141 119 120 120 120 120 120 120 121 119 120 120 120 120 120 120 120 120 120 120 121 122 123 124 70 70 70 70 70 70 70 70 70 70 70 70 70 70 70 70 70 70 70 70 70 70 70 70 70 70 70 70 70 70 70 70 70 70 70 70 70 70 70 70 70 70 70 70 70 70 70 70 122 123 132 120 133 126 184 184 184 184 200 70 70 132 121 141
70 70 70 70 70 70 70 70 70 70 70 70 70 70 70 70 70 70 70 70 70 70 70 70 70 70 70 70 70 70 70 70 141 122 169 169 185 70 70 124 141 122 169 169 169 169 169 125 124 122 169 226 169 169 226 169 125 169 185 70 132 133 70 124 70 70 70 70 70 70 70 70 70 70 70 70 70 70 70 70 70 70 70 70 70 70 70 70 70 70 70 70 70 70 70 70 70 70 70 70 70 70 70 70 70 70 70 70 70 70 70 70 122 70 70 70 227 126 228 229 229 229 230 70 70 70 124 141
70 70 70 70 70 70 70 70 70 70 70 70 70 70 70 70 70 70 70 70 70 70 70 70 70 70 70 70 70 70 70 70 141 122 184 231 232 127 128 132 120 133 184 184 184 184 184 126 124 122 229 233 184 228 234 229 126 229 230 70 70 70 70 124 70 70 70 70 70 70 70 70 70 70 70 70 70 70 70 70 70 70 70 70 70 70 70 70 70 70 70 70 70 70 70 70 70 70 70 70 70 70 70 70 70 70 70 70 70 70 70 70 122 70 127 128 235 126 230 70 70 70 70 70 70 70 124 141
70 70 70 70 70 70 70 70 70 70 70 70 70 70 70 70 70 70 70 70 70 70 70 70 70 70 70 70 70 70 70 70 141 122 184 199 200 138 139 70 227 169 228 229 229 236 184 126 132 133 70 237 184 200 70 70 126 70 70 70 70 70 70 124 70 70 70 70 70 70 70 70 70 70 70 70 70 70 70 70 70 70 70 70 70 70 70 70 70 70 70 70 70 70 70 70 70 70 70 70 70 70 70 70 70 70 70 70 70 70 70 70 182 130 238 139 239 126 70 70 70 70 70 70 70 127 124 141
70 70 70 70 70 70 70 70 70 70 70 70 70 70 70 70 70 70 70 70 70 70 70 70 70 70 70 70 70 70 70 70 141 122 184 169 200 70 240 241 237 184 200 70 70 237 184 126 185 70 70 235 229 230 70 241 126 70 70 129 130 130 130 157 70 70 70 70 70 70 70 70 70 70 70 70 70 70 70 70 70 70 70 70 70 70 70 70 70 70 70 70 70 70 70 70 70 70 70 70 70 70 70 70 70 70 70 70 70 70 70 70 119 120 133 239 70 126 70 70 70 70 70 70 129 130 157 141
70 70 70 70 70 70 70 70 70 70 70 70 70 70 70 70 70 70 70 70 70 70 70 70 70 70 70 70 70 70 70 70 141 122 229 229 230 70 70 70 235 229 230 70 70 237 184 126 200 70 241 242 70 70 243 244 126 70 129 140 141 141 141 141 70 70 70 70 70 70 70 70 70 70 70 70 70 70 70 70 70 70 70 70 70 70 70 70 70 70 70 70 70 70 70 70 70 70 70 70 70 70 70 70 70 70 70 70 70 70 70 70 122 70 70 70 239 126 128 70 70 70 70 129 140 141 141 141
70 70 70 70 70 70 70 70 70 70 70 70 70 70 70 70 70 70 70 70 70 70 70 70 70 70 70 70 70 70 70 70 141 122 70 223 130 245 246 70 70 70 70 70 70 235 229 126 230 70 240 127 128 243 244 70 126 129 140 141 141 141 141 141 70 70 70 70 70 70 70 70 70 70 70 70 70 70 70 70 70 70 70 70 70 70 70 70 70 70 70 70 70 70 70 70 70 70 70 70 70 70 70 70 70 70 70 70 70 70 70 70 122 70 70 70 247 248 139 70 70 70 129 140 141 141 141 141
70 70 70 70 70 70 70 70 70 70 70 70 70 70 70 70 70 70 70 70 70 70 70 70 70 70 70 70 70 70 70 70 141 122 70 124 141 141 249 250 246 70 70 70 70 70 70 126 70 129 130 238 139 244 223 130 130 251 141 141 141 141 141 141 70 70 70 70 70 70 70 70 70 70 70 70 70 70 70 70 70 70 70 70 70 70 70 70 70 70 70 70 70 70 70 70 70 70 70 70 70 70 70 70 70 70 70 70 70 70 70 70 122 70 70 70 243 125 70 70 70 70 156 120 120 120 120 121
70 70 70 70 70 70 70 70 70 70 70 70 70 70 70 70 70 70 70 70 70 70 70 70 70 70 70 70 70 70 70 70 141 122 123 124 141 141 141 141 249 250 246 70 70 70 70 126 129 140 141 122 70 70 124 141 141 141 141 141 141 141 141 141 70 70 70 70 70 70 70 70 70 70 70 70 70 70 70 70 70 70 70 70 70 70 70 70 70 70 70 70 70 70 70 70 70 70 70 70 70 70 70 70 70 70 70 70 70 70 70 70 122 70 70 241 244 126 70 70 70 70 70 70 70 220 252 124
70 70 70 70 70 70 70 70 70 70 70 70 70 70 70 70 70 70 70 70 70 70 70 70 70 70 70 70 70 70 70 70 141 122 123 124 141 141 141 141 141 141 249 130 183 222 223 130 251 141 141 122 222 222 124 141 141 141 141 141 141 141 141 141 70 70 70 70 70 70 70 70 70 70 70 70 70 70 70 70 70 70 70 70 70 70 70 70 70 70 70 70 70 70 70 70 70 70 70 70 70 70 70 70 70 70 70 70 70 70 70 70 122 222 222 222 247 253 253 254 222 223 130 130 130 183 123 124
70 70 70 70 70 70 70 70 70 70 70 70 70 70 70 70 70 70 70 70 70 70 70 70 70 70 70 70 70 70 70 70 141 122 123 124 141 141 141 141 141 141 141 141 122 225 124 141 141 141 141 122 225 225 124 141 141 141 141 141 141 141 141 141 70 70 70 70 70 70 70 70 70 70 70 70 70 70 70 70 70 70 70 70 70 70 70 70 70 70 70 70 70 70 70 70 70 70 70 70 70 70 70 70 70 70 70 70 70 70 70 70 122 225 225 225 255 255 255 255 225 124 141 141 141 122 123 124
70 70 70 70 70 70 70 70 70 70 70 70 70 70 70 70 70 70 70 70 70 70 70 70 70 70 70 70 70 70 70 70 141 122 123 124 141 141 141 141 141 141 141 141 141 141 141 141 141 141 141 141 141 141 141 141 141 141 141 141 141 141 141 141 141 141 141 141 141 141 141 141 141 141 141 141 141 141 141 141 122 256 256 256 256 256 256 256 256 256 256 256 256 256 256 256 256 256 256 256 256 256 256 256 256 256 256 256 256 256 256 124 141 141 119 120 120 120 120 120 120 120 120 120 121 122 123 124
70 70 70 70 70 70 70 70 70 70 70 70 70 70 70 70 70 70 70 70 70 70 70 70 70 70 70 70 70 70 70 70 141 122 123 124 119 120 120 120 121 119 120 120 120 120 120 120 120 120 120 120 120 120 120 120 120 120 120 120 120 120 120 120 120 120 121 141 119 120 120 120 120 120 120 120 121 141 141 141 122 256 256 256 256 256 256 256 256 256 256 256 256 256 256 256 256 256 256 256 256 256 256 256 256 256 256 256 256 256 256 124 141 141 122 169 169 169 169 169 169 169 169 169 124 122 123 124
70 70 70 70 70 70 70 70 70 70 70 70 70 70 70 70 70 70 70 70 70 70 70 70 70 70 70 70 70 70 70 70 141 122 123 124 122 169 169 169 124 122 169 169 169 169 169 125 169 169 169 125 257 258 257 258 257 258 257 258 169 125 169 259 169 259 124 141 122 70 227 169 169 125 169 169 124 141 141 141 122 256 256 256 256 256 256 256 256 256 256 256 256 256 256 256 256 256 256 256 256 256 256 256 256 256 256 256 256 256 256 124 141 141 122 184 184 184 184 184 184 184 184 184 124 122 123 124
70 70 70 70 70 70 70 70 70 70 70 70 70 70 70 70 70 70 70 70 70 70 70 70 70 70 70 70 70 70 70 70 141 122 70 124 122 229 229 229 124 122 229 236 184 228 229 126 229 229 236 126 260 261 260 261 260 261 262 263 236 126 184 264 184 264 132 120 133 70 237 184 184 126 184 184 124 141 141 141 122 256 256 256 256 256 256 256 256 256 256 256 256 256 256 256 256 256 256 256 256 256 256 256 256 256 256 256 256 256 256 124 141 141 122 229 229 229 229 229 229 229 229 229 124 122 123 124
70 70 70 70 70 70 70 70 70 70 70 70 70 70 70 70 70 70 70 70 70 70 70 70 70 70 70 70 70 70 70 70 119 133 70 132 133 127 128 70 132 133 70 237 184 200 247 253 254 70 235 126 229 229 229 236 184 184 200 70 235 126 229 229 229 236 169 125 185 70 235 229 229 126 229 229 124 141 141 119 133 256 256 256 256 256 256 256 256 256 256 256 256 256 256 256 256 256 256 256 256 256 256 256 256 256 256 256 256 256 256 132 121 141 122 265 266 267 267 267 267 267 267 268 124 122 123 124
70 70 70 70 70 70 70 70 70 70 70 70 70 70 70 70 70 70 70 70 70 70 70 70 70 70 70 70 70 70 70 70 122 169 184 185 70 138 139 239 70 70 70 235 229 230 70 125 70 70 70 126 70 70 70 237 184 184 200 70 70 126 70 70 70 235 229 126 230 70 70 70 70 269 70 70 132 120 120 133 270 271 272 272 272 272 271 272 272 272 272 271 272 272 272 272 271 272 272 272 272 271 272 272 272 272 271 272 272 272 272 270 132 120 133 273 274 275 70 70 70 241 242 70 124 122 123 124
70 70 70 70 70 70 70 70 70 70 70 70 70 70 70 70 70 70 70 70 70 70 70 70 70 70 70 70 70 70 70 70 122 276 229 230 70 70 239 70 239 70 277 278 70 70 127 126 70 129 130 130 245 246 70 235 229 229 230 70 247 253 254 70 70 70 70 126 70 70 127 128 247 253 254 241 70 70 70 279 280 281 282 283 284 282 281 282 283 284 282 281 282 283 284 282 281 282 283 284 282 281 282 283 284 282 281 282 283 284 282 280 285 70 70 286 70 287 70 70 70 240 127 128 124 122 123 124
70 70 70 70 70 70 70 70 70 70 70 70 70 70 70 70 70 70 70 70 70 70 70 70 70 70 70 70 70 70 70 70 182 130 131 70 70 70 70 239 127 128 137 70 70 70 138 126 129 140 141 141 141 249 250 246 70 70 70 70 70 125 70 70 288 70 70 126 70 70 138 139 70 125 243 244 70 70 70 289 290 291 292 293 294 292 291 292 293 294 292 291 292 293 294 292 291 292 293 294 292 291 292 293 294 292 291 292 293 294 292 290 295 70 70 296 70 297 70 70 70 70 138 139 124 122 123 124
70 70 70 70 70 70 70 70 70 70 70 70 70 70 70 70 70 70 70 70 70 70 70 70 70 70 70 70 70 70 70 70 141 141 298 131 70 70 70 70 299 139 70 70 70 129 130 130 251 141 141 141 141 141 141 249 250 246 70 70 70 126 128 243 244 70 129 130 131 70 240 242 70 126 244 70 300 301 130 183 302 303 304 304 304 304 303 304 304 304 304 303 304 304 304 304 303 304 304 304 304 303 304 304 304 304 303 304 304 304 304 302 223 130 183 305 306 307 70 70 70 70 70 70 132 133 123 124
70 70 70 70 70 70 70 70 70 70 70 70 70 70 70 70 70 70 70 70 70 70 70 70 70 70 70 70 70 70 70 70 141 141 141 298 131 70 70 70 224 70 70 70 129 140 141 141 141 141 141 141 141 141 141 141 141 249 250 246 70 126 139 244 70 129 140 141 298 131 70 240 127 126 300 301 308 141 141 182 183 255 255 255 255 255 255 255 255 255 255 255 255 255 255 255 255 255 255 255 255 255 255 255 255 255 255 255 255 255 255 223 157 141 122 128 70 70 70 70 70 70 70 70 70 220 309 124
70 70 70 70 70 70 70 70 70 70 70 70 70 70 70 70 70 70 70 70 70 70 70 70 70 70 70 70 70 70 70 70 141 141 141 141 298 183 222 222 224 222 222 223 251 141 141 141 141 141 141 141 141 141 141 141 141 141 141 249 130 130 130 183 222 156 120 120 120 310 222 223 130 130 311 141 141 141 141 141 122 256 256 256 256 256 256 256 256 256 256 256 256 256 256 256 256 256 256 256 256 256 256 256 256 256 256 256 256 256 256 124 141 141 182 238 222 222 222 222 222 222 222 223 130 130 130 157
70 70 70 70 70 70 70 70 70 70 70 70 70 70 70 70 70 70 70 70 70 70 70 70 70 70 70 70 70 70 70 70 141 141 141 141 141 122 225 225 224 225 225 124 141 141 141 141 141 141 141 141 141 141 141 141 141 141 141 141 141 141 141 122 225 255 255 255 255 255 225 124 141 141 141 141 141 141 141 141 122 256 256 256 256 256 256 256 256 256 256 256 256 256 256 256 256 256 256 256 256 256 256 256 256 256 256 256 256 256 256 124 141 141 141 122 225 225 225 225 225 225 225 124 141 141 141 141